+---------------------------------+
|                                 |
|                                 |
|   +---------+    ---------+     |
|   |                       |     |
|   |                       |     |
|   |    +------------------+     |
|   |    |                  |     |
|   |    |                  |     |
|   |    |      +-----------+     |
|   |    |                        |
|   |    |                        |
+---+----+------------------------+
